1 1
11 6
#############
#   #########
###   #######
#####   #####
#######   ###
#########   #
########### #
#############