1 1
28 9
##############################
#    #########################
####    ######################
#######    ###################
##########    ################
#############    #############
################    ##########
###################    #######
######################    ####
#########################    #
##############################